h	h
aː	aː
m	m
ã	ã
j	j
ɯ	ɯ
ŋ	ŋ
ɤ	ɤ
ɲ	ɲ
ɾ	ɾ
s	s
u	u
p	p
oː	oː
k	k
ũ	ũ
ẽ	ẽ
e	e
w	w
t	t
uː	uː
õ	õ
n	n
ĩ	ĩ
ɛ	ɛ
ɔ	ɔ
i	i
b	b
d	d
ãː	ãː
ɐ	ɐ
ʃ	ʃ
õː	õː
ʁ	ʁ
ɯː	ɯː
ɔː	ɔː
ɤː	ɤː
g	g
eː	eː
c	c
l	l
á	á
ÿ	ÿ
ɛː	ɛː
ʒ	ʒ
ẽː	ẽː
j́	j́
ɾː	ɾː
ɔ̃	ɔ̃
ã	ã
â	â
ɛ̂	ɛ̂
ɛ̃	ɛ̃
ɾ̃	ɾ̃
ɔ̂	ɔ̂
ĩ	ĩ
ũ	ũ
í	í
ó	ó
a	a
o	o
ê	ê